



F 164,169,20
C 153,204,255




NO textures/simonkraft/wet_sponge.xpm
SO textures/simonkraft/wet_sponge.xpm
WE textures/simonkraft/wet_sponge.xpm
EA textures/simonkraft/wet_sponge.xpm


    111111111111111111111
    101000001000000000001
    101010101011111110001
    100010100010000010001
    111110101111101011101
    100000101000101000001
101111101011101111111
10100  0001010100000101
101              101
1 10                 1
10 11         0 10101
1000 00101  010001010001
1100000000000000  10001
1000000000 00000000001
1010  0 000100010101
101010000000001010101
1000100000 00000010001
101010111  010000000001
1N1   000 000000000001
1111111111111 11111111







