   WE                          textures/simonkraft/wet_sponge.xpm
NO      textures/simonkraft/wet_sponge.xpm



SO textures/simonkraft/wet_sponge.xpm
EA textures/simonkraft/wet_sponge.xpm

F   69,222,199

C 235,198,52




1111111111111111111111111111111111111111
1000000000000000000000000000000000000001
1000000000000000000000000000000000000001
100000000N000000000000000000000000000001
1000000000000000000000000000000000000001
1000000000000000000000000000000000000001
1000000000000000000000000011100001010101
1000001111100111011100011101110000010001
1000001000000111011100000000000000000001
1000011100000011101110001100011011100001
1000011100000011101110011101100011100001
1000011100000011101110011101101110100001
1000000000000000000000001010000000000001
1000001000011101110001110110000100010001
1000001000000000000111011100000000000001
1000011100111010011101110000111011100001
1000011100000110011101001011101011100001
1000011100000100111011100001011011100001
1000000000000000110000001010000000000001
1000001111000111011100111011101010100001
1000000000000111011100011101110000000001
1000000000000111011100000000000000000001
1000011100000100110001110111011011100001
1000011100000100000000110111011011100001
1000011100000000001110110000000000000001
1000011100000111001110111000111011100001
1111111111111111111111111111111111111111
